11111111111111111111111111111111111111111111111111111111111111111
1E000000000011111111111111111111111111111111111111111111111111111
10000101001011111111111111111111111111111111111111111111111111111
10100100101011111111111111111111111111111111111111111111111111111
1P0000000C0011111111111111111111111111111111111111111111111111111
11111111111111111111111111111111111111111111111111111111111111111
10000101001011111111111111111111111111111111111111111111111111111
10100100101011111111111111111111111111111111111111111111111111111
10000101001011111111111111111111111111111111111111111111111111111
11111111111111111111111111111111111111111111111111111111111111111
11000000000011111111111111111111111111111111111111111111111111111
10000101001011111111111111111111111111111111111111111111111111111
10100100101011111111111111111111111111111111111111111111111111111
100000000C0011111111111111111111111111111111111111111111111111111
11111111111111111111111111111111111111111111111111111111111111111
10000101001011111111111111111111111111111111111111111111111111111
10100100101011111111111111111111111111111111111111111111111111111
10000101001011111111111111111111111111111111111111111111111111111
11111111111111111111111111111111111111111111111111111111111111111