1111111111111111
1000000000000001
1000P00000000001
1000000C00E00001
1111111111111111