1111111111111111111111111111111111
1E0000000000000C00000C000000000001
1010010100100000101001000000010101
101P01001010101000100100000001
1111111111111111111111111111111111
