1111111111111111111111111111111111111111111111111111111111
1E0000000000000C00000C000000000000000000000000000C00000001
10100101001000001010010000000101010000000000000C0000000001
1010010010101010001001000000010101000000000000000000000001
100000000C00C000000C000000000000C0000000000000000000000011
1111111111111111111111111111111110000000000000000000000011
100000000000000C00000C000000000000000000000000000000000001
101001010010000010100100000001010100000000000C000000000001
1010010010101010001001000000010101000000000000000000000001
100000000C00C0000000000000000000C0000000000000000000000011
11111111111111111111111111111111100000000000C0000000000011
100000000000000C00000C000000000000000000000000000000000001
101001010010000010100100000001010100000000000C000000000001
1010010010101010001001000000010101000000000000000000000001
1P0000000C00C0000000000000000000C0000000000000000000000011
1111111111111111111111111111111111111111111111111111111111
