1111111111111111
1000000C0C000001
1E1P010010101011
1111111111111111
